NO ./textures/path.xpm
SO ./textures/south_wall.xpm
WE ./textures/western_wall.xpm
EA ./textures/east_wall.xpm

F     28     ,          100,                      0
C 225       ,                 30      ,  0



        1111111111111111111111111
        1000000000110000000000001
        1011000001110000000000001
        1001000000000000000000001
1111111110110000011100000000000011
1000000000110000011110011111111111
1111011111111101110110001000111111
1111001111111101110110111110111111
1100000011010101110000001000111111
100000011100000110000001000111111
1000000111000000000101001000111111
11000001110101011111000000000111111
1111N011111111111111111100011111111
1111111111111111111111111111111111
